S#   #   #           #       #   #   ###
 # # # ### ######### ### ### # # # #####
 # # #         #   #     # # # #   #   #
 # # # ####### ### ####### # # ##### ###
 # #       #   # #   #   #   #   #     #
 ####### ### ### # # ### # ### # # # # #
       # #   #   # #       #   #   # # #
###### ### ### # # ######### ####### # #
     #     #   # #   #   #     # #   # #
 ### ####### ### ### # # ##### # # # ###
 #     #   # #     #   #   # #   # #   #
 ### # # # # ############# # ### # ### #
   # # # # # #   #       # #     # #   #
 # ##### # # # # # ### # # ####### ### #
 #       # # # #   #   # # #       #   #
 ### ##### # # ##### # ### # # # ### ###
 # #   #     #   # # # # # # # # #   # #
 # ##### ####### # # ### # # ##### ### #
   #     #     # # #   #   #   # #   # #
 ### ### # ### # # ### # ### # # ### # #
 #   #   # # #   #   # #   # # # #   # #
 # ####### # ##### ### ### ### # # ### #
 #   #     #     #   #   # #   # #   # #
 # # # # ### ### #E# # ### # ### ### # #
 # #   #     #     # #       #         #
