S# #                 #               #   #   ###     #             #             #         #     # #
 # ### ############# ### # # # ##### # # # # ### ### ######### ##### # ########### ####### # ### # #
   #     #         #   # # # # #     # #   #   #   # #   #     #     #       #   #     #   # #     #
## ### ### ####### ### ##### # # ####### ##### # # # # # # ##### ##### ### # ### # ### # ### # # # #
 #   #     #     #   #     # # #         # #   # # #   # #       #   #   # # #   # #   #   # # # # #
 ### # ##### ####### ##### ### ########### # ##### ##### # ####### # ### # ### ### # # # ### # #####
 #   # #           # #   #   # #   #       #         # # #     #   #   # #       # # # # #   # #   #
 # ### ##### ### # # # # ### # # # # # ############### # ####### ##### ### ### ### # ##### ### # # #
   # # #   #   # # # # #     #   # # #   # # #         #       # # #   # # #   #   # #       #   # #
 ### # # # ####### # ### ####### # ##### # # # # ##### ####### # # # ### # # ### ### # ### ####### #
 #     # # #       #   #   #     #   #     #   # #     # #   #   #   # #   #     # # # # # #       #
 ##### # # ### ### ### ### ######### # # ### ### # ##### # # ##### ### # ######### # # # # # ### ###
     #   # # # # # # #   #         # # #       # # #   #   #   #   #       #       # # # # # # # # #
#### ##### # # # # # ### ######### # ### ####### # # # # ### ### ### # ### ####### # # # ### # # # #
   # # # #   # #       #   #   #   # #   #     # # # #     #   # # # # #   #     # # #   #   #     #
 # # # # ### # ##### ##### ### # ### # ##### # # # ########### # # ####### ### # # # ### # #########
 # # #         #   #   #   # #   #   #       # # #             #         #     #   #   # # #       #
 ### ### ####### # ##### ### # ### ########### # ############# ######### # ######### ### # # ##### #
   #   #   #   # # #     #   #   # #     #     #     #     # #       # # # # #     #     #   #     #
## ### ### ### # # # ####### ### # # ### ##### ##### # ### # ##### ### # # # # ### ### ####### #####
   # #   #     # # # #       #   #   # # #   #   #   # #   # # #   # #   #   # # #   #   # # #     #
 # # ### # ##### # # # ### ### ### ### # # # # ### ### # ### # # ### # ### ### # ### # # # # ### ###
 #     # # #     #   # #     # #   #   #   # # #   #   #       #   # #   # #   #     # # #   # #   #
 # ##### # # ########### # ### # ### ####### # # ### # ##### ##### # ### ### ### ####### ### # ### #
 # #     # #   #     #   # #   # #     #     # #   # #     # #   #   #       # #       #     #   # #
 ### ##### ### # ### # ##### ### ##### # ######### # ##### # # # ### ######### ####### ##### # ### #
     #   # #   #   #   #     #         # #         #   #   # # # # #   #   # # #     # #       #   #
 ##### # # ### # # ##### ############# # # ########### # ### ### # # ### # # # # # ### # ####### # #
 #   # # # #   # #     #   #     ###   # #     #       #   #     # #     # #   # #   # # # #     # #
 # # # # ### ### ##### ### # ########### # ### ##### ##### # ##### ####### # # ### # # ### # #######
 # #   # #   #     #     # #             #   #   #   #   # # #       #     # #   # # #     #   #   #
 ##### # ### # ####### # # ##### ######### # ### # ### # # ### ##### # ##### ### # ####### ### # # #
 #   # #     # #   #   # #   #   #         # # # # #   # #       # #         # # # #   #         # #
 # # # ######### ### ####### # ### ########### # # # # # # ##### # ########### # # ### ########### #
 # #   #         #       #   # #     #         # #   # # # #   #   #     #     #     #     #   # # #
 # ##### ######### ##### # ### ####### ####### # # ######### # ##### ### ### # ### # # ### # # # # #
   #       #   #   #     #   #     #   #     #   # # #       #     #   # #   #   # #   #   # # #   #
#### ##### # # # ### ####### # ##### ### ######### # # ######### # # ### # ##### # ### ##### # # ###
   #     # # # #   #         #   #   #     #     # # # #   #     # # #   # ###     #   #     #   # #
 # # ### ### # ### ############# # ### ### # ### # # # ### # ##### # # ############# # # ######### #
 # #   #     #   #   #           # #     #   #   #   # #   # #     # #           #   # #   #   #   #
 ### ##### ##### ### # ########### ##### ##### # # ### # # # # ##### ########### ######### ### ### #
   # #   # # #       #       # #   #     #   # # # # # # # # #   #   #   #     #       # # # #   # #
 # # # ##### ######### ##### # ### # ##### # # ### # # # ### ### # ### ### # ######### # # # # # # #
 # # # #       #     #   #   #     #       # #     #   #   #   # # #       #   # #       #   # # # #
## # # # ##### ### ##### # ##### ############# ##### ### ##### # # ####### ### # # ##### ### # # # #
   # # #     #       #   # # # #             # #   #   #   #   # # #     # #     #     #   # # #   #
 ### # ##### # # ##### ### # # # ########### # ### ### ### # ##### # # ### # ### # # ####### # ### #
     #     # # #         # #   # #     #     #     # #     # # #   # #     #   # # #   #     # # # #
 ##### # ### ############# # # # # # ### ######### # ### ### # # ### ######### # # # # # ##### # # #
 #   # # #   #         #   # #   # # #   #     #   #   #   # #   # # #         # # # # # #     #   #
 # # # # # ### # ##### # ### # # # # # ### ### # ##### # # # # ### # # ### ##### ##### # ### ### ###
 # #   #   #   # #   #   #   # # # # # # #   # # #     # # #   #   # # #   #   #   #   #   # #     #
 # ######### ### # # ### ####### # # # # ### # # # ##### ####### ### # ##### # # ### ##### # ##### #
 #     #   # #   # #     #     #   # # #     #       #   #       # # #       # #   #       #   #   #
 ##### # ### ########### # ### ##### # ### ########### ######### # # ######### ############### # ###
 #   # #   #           # #   #     # #   #   #     # #         #     #       # #     #     #   #   #
 ### # ### ########### # ### ##### ### # ##### # # # ######### ### ####### # # # ### # ### # ### # #
 #     #   #         # # #       # #   #       # # # #       # #           # #   #     #   #   # # #
 ### ### ### ### ### # ######### # ######### ### ### # ### ### # ################### # # ### # ### #
   #     # #   # #   #           #       #   #   #     #   #   #   #         #     # # #   # #   # #
## ##### # ##### ##################### # ##### # # ##### ### ####### ####### ### # ### ### ### # # #
 # #   #     #     #       #       # # # #   # # # #   #   #     #   # #     # # #   # # # #   # # #
 # # # ##### ### # # # ### ##### ### ### # # # # # ### # # ##### # ### # ##### # ### # # # ##### ###
   # #   # #   # #   # #     #       #   # #   # # # # # #     # # #   #       # # #   #       #   #
 ##### ### ### ####### ##### ##### # # ### ### ### # # ##### ### # ### # ##### # # # ######### # # #
     #       # #       #   # #   # # #   # #   # # #   # #   #   # # #     #     #   # #     #   # #
#### # ### # # # ####### # # # # # # ### # ##### # # # # # ### ### # # # ########### # # ### ### ###
   # #   # # #   # #   # #     #   #   # #   #   #   #   #     #   # # # #   #     #   # # #   #   #
## # ### ### # ### ### # ############### # ### # ####### ####### # # # ### # # ### ##### # ### ### #
 #   #     # # #       #       #         # #   #   #   # #   #   # # # #   #   # #     # # # # #   #
 # ####### # # # # ### ### ##### ######### # ##### # # # # # ##### # # # ####### ##### # # # # ### #
     ###   #   # # # #   # #     #   #       #   #   #   # #     # # # # #       #     # # # #   # #
 ################# # ### # # ##### ### ##### ### ######### ##### # # # # ##### # # ### # # # ### ###
 #             #   #     # # #   #     #           #   # #   #     #   # #     # #   # #       #   #
 ##### ####### # ######### # # # # ####### ##### ### # # # # ########### # # ####### ####### ##### #
 #     #   #   # #   #     # # # # #   #   #       # #     #       #       #       #     #   #   # #
 # ##### ### ### # # # ##### # # # # ############# ### ######### # # ########### ##### ### ### # # #
   #       # #   # # # # # # # #     #       #   # #   # # #   # # # #   #     # #   # #   #   # # #
###### ### # ### # # # # # # # # ##### ### ### # # ### # # # # ### # # ##### ### # # # # ### ### # #
   #   #   #   #   #   #   # # # # # #   #     # #   #     # #     # # #       # # #   # # # #     #
 # # ### ##### ### ##### # # ### # # ### ####### ### ### ### ####### # ####### # # ### # # # ### ###
 #   #   #   # # #   #   # #   #     # # #   #   #   #     # #     #   #     #   # #   #   #   #   #
 ##### ### # # # ### ##### ### ####### # # ### ### # ####### # ### # ### ### # ### ##### ### # #####
 ###     # #   #     #       #         # #   #   # # #   #       #   #   #   #   #         # #     #
 ### ### # ####### ### # # ########### # ### ### ### # # ####### ##### ### ####### ##### # # ##### #
 ### # # #       #     # #       #   #       #   #     # #   # # #     # #   #     #   # # # # #   #
 ### # ######### ##### # ######### # ########### # ##### # # # # # ##### ### # ##### # ##### # # # #
   # #       #   #   # # #         # #         # # #     # # # # # #   #   # #   #   #     #   # # #
 ### ### ### ### # # ##### ####### # ### ##### # ##### ### # # # # ### ### # ##### ####### # ### ###
   #   # # #   # # #     #     #   #     #     #     # #   # #   #   # #   #     #     # # #   #   #
 # # # # # # ### # ##### # # # ########### ##### ### # # ### # ##### # # # ##### ##### # # ### ### #
 # # # # # # #   #   #   # # # #           #       # # # #   # #     #   #   # #       # #   #   # #
## ### # # # # ### ##### ### # # ################### # # ### ##### ### # ### # ######### ### ##### #
   #     #   # #     #     # # #             #     # # # #         #   # #     #           #       #
 # ### ####### ##### ##### ### ########### # # ### # # # ########### ### ##### # ####### ######### #
 #   # #           # #         #     #     #   #     # #   # #   #     #     # #       #   #   # # #
 ### ### ### # # # # # ######### ##### ### ### # ##### ### # # # # ### # ### ####### ##### # # # # #
   #       # # # #   # ###               # #   #   #       #   #   ### #   #    E        #   #     #
####################################################################################################
