S    #     #         #   #         # #   #     # # #     #           #       #             #   #   #
#### # ### ##### ### # # # ### ### # # # # ##### # ### # ### ### # ### ### # ### ####### ### # # # #
 #     # #   #     #   #   # # #   # # #             # #   #   # # #     # #   # # #   #     # # # #
 ####### ### ############# # # # ### # ########### # # ### ####### # ##### ### # # ### ####### # # #
   #       #       #   #     # # #   # # #         #   #         #       # #   # # #   #   # #   # #
 # # ##### ####### # # # ##### # # ### # # ##################### ##### ### # ### # ### ### # ##### #
 # #     # #     #   # # # #   #   #   # #   #         #       #     # #   # # #     #   #   # #   #
 ####### # # ######### # # # ####### ### ### # ######### ### # ##### ### ### # ##### # # # ### # # #
   # # # #   #       # #   #     #   # #   # #       #     # # # # #     #   #   # #   #       # # #
## # # # ### # ### # # ####### # # ### # ### ####### # ### ##### # ####### ### # # ### ##### ### # #
   #   #   #     # # #     #   # # #   #   #       #     #     #     #   # #   #   #   #   # #   # #
 # # # ### ##### # ####### ##### # # ##### ####### ########### # ### # # # # # # ### ### # ##### ###
 #   #   # #   # #       # #   #   #         # # #       #   #     #   # # # # # #   #   #     # # #
## ##### # # # ####### # # # # # ### # ##### # # ### ### # # ##### ### # # ### # # ### ####### # # #
 # #   #     # #     # # #   # # #   # #     #   # #   #   #   # #   # # # #   # #   # #     # #   #
 # # ########### # # # # ##### # ##### ##### # # # # ####### # # ### # ### # ##### # # # # ### # # #
   #   # # #     # #   # #   # # #     #   #   # # # #     # # #   # #     #       # # # # #   # # #
 # # # # # # ########### # # # # # ##### # ##### # ### ### ### # ### ############# ### # ### ##### #
 # # #     # #     #   #   # # # # #   # #         #   #       # #   #         #   #   #   # #   # #
## ##### ### # ### # # ### ### # # ### # ######### # ########### # ##### ##### ##### ### # # # # # #
   #     #   #   #   # #   # # # #   #   #       # #   #         # #       #         #   #   # #   #
 ### # ### ##### ### # ##### # # ### # ### ##### ##### # ### ### # ##### # ########### ####### ### #
 #   #   #     #   # #     #   # #   #   # #   #       #   # #   # # #   # #   ###     # ###     # #
 # # # # ##### ### ####### # ### # ##### # ### ########### # ##### # # ### # # ##### ### ####### ###
   # # #   #   # #   #   #   # # # ### # #   # # # #       #       # # #   # #       #             #
######## ### # # ### ### ##### # # ### # ### # # # # ############### # # ### ########### # #########
       # #   #   #     #         # # #   #   #     # # #     # # #     # # # #   # #     # #       #
 # ### ### ### ####### ####### ### # # ### ### ##### # ### # # # # ##### # # # # # # ####### # ### #
 # #   #   #     #   #     # # #   #   #   # #       #     # #         # #     # #   #       # #   #
 ##### # ####### # ####### # # # ##### # ### # ####### ####### ######### # # ### ### # ####### # ###
 #     #     #   #       # #     #   # # #   # #                 #     # # # #   #   #     #   #   #
 ##### ##### ### ### ### # ####### # # # ### # ####### ######### # ### # ##### ### ### # ### ##### #
 #   #   #   # # # # #   #     #   # # # #   #       #   #   #   #   # #     #   #     # #     # # #
 ### # # # # # # # ### # ##### # ### ### # ######### ##### # ####### # ##### ### ### ######### # # #
   #   #   # # #     # # #   #   # # # # #           # #   #         #     #   # #   #   #     #   #
## ######### # ##### # # # ####### # # # ##### ####### # ####### ######### ### # ##### # # ##### ###
   #           #   #   #         #   #   #   #   #       #     # #   #   # #   #     # # #     # # #
 ### ########### # ####### ##### # ##### # # ### # ########### ### # # ### # ####### # # # ### # # #
   # #         # #       #     # #   #     # #   # #           #   # # #   # #     #   # # #   # # #
## ### ####### # ####### ##### ##### # # ### ### # # ####### ####### # # ### ##### ##### ### ### # #
   #   # #   #     #     #   # #     # #   #   #   #   #     #       # #   # #         #     #     #
## # ### # ######### ##### # # # ########### # ####### # ####### ### # ### # # ############### #####
   # # #         # #   # # # # #     #     # # #   #   #   #     #     # # # #           # #   #   #
 ### # # ####### # ### # # # # ##### # ### ### # # # ##### ### ##### ### # # ### ####### # # ##### #
   # #         #   #   #   #   #   #   # #   # # # #   # #     #   # #   #   #   #     #   #     # #
 # # ####### ### ### ### ####### # ##### ### # # # ### # ####### # # ### ##### ### ### ### ##### # #
 # #     # # #     # #   #       # #       #   # #     #       # # # #       #     #   # #     # # #
 # ##### # # # ### # # ########### # # ########### ##### ##### # # # # ### # # ##### ### ##### # # #
 #     # #   # #   # #   #   #     # #         #     # # #   #   #   # #   # #     # #   #     # # #
 # ### # # ### ##### ### # # ### # # # ####### ##### # # # ############# # # ### ### ### # ##### # #
 # # #   #   #   #   # # # # # # #   #   #         # # #     #   #     # # # # #   #   #       # # #
## # ######### ### ### # # # # ######### # ####### # # ##### ### ### # ##### # ### ### ######### # #
 # #       #     #   # #   #         #   # #     #   # #     #       # #     #   # # #     #   #   #
 # ### ### # ### ### # ############# ##### # # # ##### # ##### ####### # # ### # # # ##### # # # ###
 #     #   # #   #   #     #     # #     # # # # #       #   #       #   # #   # # #   # #   # #   #
 ####### ##### # # ### ##### # ### ##### # ### # # ######### # ##### # ##### ### # ### # ##### ### #
 #             # # # #       # #   #     #   # #     #       #     # #     #   # #     # #   #     #
 # ######### ##### # # ####### # # # ####### ##### # ### ### # ##### ### ### ### ##### # # # #######
     #   #   #     # #   #   #   # # #       #   # #   #   # #   #   ### # # # #       #   #       #
###### # ##### ##### ### ### ##### # ### ### # # ##### # # # ##### ##### # # # ############# ### ###
       #     #   #     #     #   #   ###   #   #   # # # # #       #   # # #     #   #       # #   #
 ########### ### ### # ### # # # ######### ####### # # ### ######### ### # ##### # # # ### ### ### #
       # #       # # #     #   # # #       #   #   # #     #       # #   #     # # #   #   #       #
###### # # ####### # ########### # ### ##### # # ### ######### ##### # ### ##### # ##### ### #######
   #   #   #     #     #       #   #     #   #   # # #     #       # #     #     #     # # # #     #
 # # ### ### ### # ### # ##### # # ####### ####### # # # # # # ### # ### ### ########### # # ### # #
 #   #     # #   # #   # # #   # #     #   #   #     # # #   # #   #     #   #     #     # # # # # #
 ########### # ######### # # ######### ### # # # # # # ####### ##### ### # ##### # # ##### # # # ###
   #       # #     #     # #   # #         # # # # # # #     #     #   # # #     # #   #   #   # # #
## # ##### # # ### # ##### ### # # ### ##### # ### ### # ### ##### ### ### # ##### ### # # ### # # #
 #   #   #   # #   #   #     # #   #     #   #   #     # #       #       # # #     #   # #     #   #
 # ##### ##### ### ### ### ### ########### ##### ### ######### # ######### # # ##### # # ### ##### #
   #         # # # # # #     #             #     #         #   #   #   #   # #   #   # # # # #     #
## # ####### # # ### # # # ################# ####### ##### # ####### # # ### ### # # ##### # # ### #
   # # #     #     #   # #         #       #       # #           # # #   #   #   # # #     # #   # #
 ### # # ######### # ### ######### # ############# # ### ### # # # # ##### ### ### # # ### # ### # #
 #   #   #     #   # # #   # #       #             # # # #   # #   #   #   # #   # #   #   #     # #
 # ##### ### # # ### # ### # # ##### # ############# # # ### ######### # ### ### ##### # ##### ### #
 #   #   #   # #     #       # # #   #   #             #   # #         # #     #     # # #       # #
 ### # # ##### ########### ### # ### # # ##### ############# # ######### ### # ##### ### ###########
 #   # #     #         #   #   # #   # #   #       #       # # #   #   #   # #       #   #       # #
 ### ####### ### ##### # ### ### # ### ############# ### # ### # # # # # # ### ####### ### ##### # #
 #       # #   # #   # # #   # #   # #     #       #   # #     # # # #   #   # # #     #   #   #   #
 ####### # ### # # # # # # ### # ### ### # # ##### ### ######### ### ####### # # # ##### ### # # ###
         # #     # #   # # #   # #     # # #   #   #   # #         #   #   # #     #   # #   # #   #
########## ####### ####### # # # ### # # ##### # ### ### ### ### ##### # # # ####### # # # ##### # #
 # #         #   # #       # # #     # #   #   #   # #     #   #   # # # # #     #   #     #     # #
 # # ##### ### # # ##### ### ####### ##### # ### # # # ### ### ### # # ### ### ### ####### # ##### #
 #   #   # #   # #       #         #     #     # # #   #   #   #     #     # #   # #   # # # #   # #
 # ### # # # ### ######### ####### ##### ### # # ##### ### ### # ######### # # # # # # # # # # # ###
   #   # #     # # # #   # #     #       # # # #   #     # #   #             # #   # # #   #   #   #
 ### ### ####### # # # # # ### ########### ####### ####### # ### ### # ######### ### # ######### # #
     # #     #     #   # # # #     #   #   #     #   #     #   #   # #   #     # #   #       #   # #
###### ### ##### # ### # # # ### # # # ### # ### ### # ############### # # ### # # ######### ### # #
         #     # #     # #     # #   #   # # #       #               # # # #   # #   # #   #     # #
 # ####### ##### ### ######### # ####### # # ############# ##### ### ##### ### # ### # # # ####### #
 # #   #     #   #       #     #   #     # #     #     #   #     # #       # # #   # #   #   #   # #
 # # # # ##### ########### ####### ### ### ##### # ### # ##### ### # ####### # ##### # ### # # # # #
 #   #       #       E             #           #     #       # #     #               #   # #   #   #
####################################################################################################
